#begin

format:
height width
val val val ...
val val val ...
val val val ...
.
.
.
val val val ...

value:
0: nothing
1: wall
2: tall column
3: food

#end
16 16

2 1 1 1 2 1 1 1 1 2 1 1 2 1 1 2
1 0 0 3 1 0 0 0 0 1 0 3 1 0 0 1
1 1 1 0 1 0 1 1 1 1 0 1 1 1 0 1
1 0 0 0 1 0 1 0 0 1 0 1 0 1 0 1
1 4 1 0 0 0 1 0 0 1 0 1 0 0 0 1
1 3 1 1 1 1 1 0 0 0 0 1 0 1 0 1
1 0 0 6 0 0 0 0 1 1 1 1 0 1 0 1
2 1 1 1 0 1 1 1 1 3 1 0 0 1 0 1
1 0 0 0 3 1 0 0 0 0 1 3 0 1 0 1
1 0 1 1 1 1 0 1 0 1 1 1 1 1 0 1
1 0 0 0 0 0 0 1 0 0 3 1 0 0 0 1
2 1 1 1 0 1 2 1 1 1 0 1 0 0 0 1
1 5 3 1 0 0 1 3 0 0 0 0 0 1 1 1
1 1 0 1 1 0 0 0 1 1 1 1 3 0 0 1
1 0 0 0 0 0 1 0 0 0 0 0 0 0 0 1
2 1 1 1 1 1 2 1 1 1 1 1 1 1 1 2

